Test N:;Tempo di Esecuzione ( Secondi );Elementi Albero Minore;Elementi Albero Maggiore;Elementi Totali;Albero Maggiore:
1;0.000126838684082;50;60;110;A
2;0.000144958496094;100;120;220;B
3;0.000162124633789;150;180;330;A
4;0.000160932540894;200;240;440;B
5;0.000165939331055;250;300;550;A
6;0.000180006027222;300;360;660;B
7;0.000179052352905;350;420;770;A
8;0.000180006027222;400;480;880;B
9;0.000180959701538;450;540;990;A
10;0.000233888626099;500;600;1100;B
11;0.000196933746338;550;660;1210;A
12;0.000211000442505;600;720;1320;B
13;0.000200033187866;650;780;1430;A
14;0.000197172164917;700;840;1540;B
15;0.00019907951355;750;900;1650;A
16;0.000198841094971;800;960;1760;B
17;0.00019907951355;850;1020;1870;A
18;0.000250816345215;900;1080;1980;B
19;0.000200033187866;950;1140;2090;A
20;0.000256061553955;1000;1200;2200;B
21;0.000216007232666;1050;1260;2310;A
22;0.000218152999878;1100;1320;2420;B
23;0.000216007232666;1150;1380;2530;A
24;0.000216007232666;1200;1440;2640;B
25;0.000221967697144;1250;1500;2750;A
26;0.000218868255615;1300;1560;2860;B
27;0.000216960906982;1350;1620;2970;A
28;0.000216007232666;1400;1680;3080;B
29;0.000216007232666;1450;1740;3190;A
30;0.000216007232666;1500;1800;3300;B
31;0.000216007232666;1550;1860;3410;A
32;0.000216007232666;1600;1920;3520;B
33;0.000217914581299;1650;1980;3630;A
34;0.000217199325562;1700;2040;3740;B
35;0.00022292137146;1750;2100;3850;A
36;0.000278949737549;1800;2160;3960;B
37;0.000220060348511;1850;2220;4070;A
38;0.000272035598755;1900;2280;4180;B
39;0.000219106674194;1950;2340;4290;A
40;0.000272989273071;2000;2400;4400;B
41;0.000236034393311;2050;2460;4510;A
42;0.000233888626099;2100;2520;4620;B
43;0.000246047973633;2150;2580;4730;A
44;0.000234842300415;2200;2640;4840;B
45;0.000235080718994;2250;2700;4950;A
46;0.00023889541626;2300;2760;5060;B
47;0.000246047973633;2350;2820;5170;A
48;0.000236034393311;2400;2880;5280;B
49;0.000261068344116;2450;2940;5390;A
50;0.000236988067627;2500;3000;5500;B
51;0.00023889541626;2550;3060;5610;A
52;0.000236034393311;2600;3120;5720;B
53;0.000237941741943;2650;3180;5830;A
54;0.000241041183472;2700;3240;5940;B
55;0.00023889541626;2750;3300;6050;A
56;0.000233888626099;2800;3360;6160;B
57;0.000235080718994;2850;3420;6270;A
58;0.000236988067627;2900;3480;6380;B
59;0.000236988067627;2950;3540;6490;A
60;0.000237941741943;3000;3600;6600;B
61;0.000237941741943;3050;3660;6710;A
62;0.000235080718994;3100;3720;6820;B
63;0.000236988067627;3150;3780;6930;A
64;0.000247001647949;3200;3840;7040;B
65;0.000236988067627;3250;3900;7150;A
66;0.000239133834839;3300;3960;7260;B
67;0.000240087509155;3350;4020;7370;A
68;0.000237941741943;3400;4080;7480;B
69;0.000240802764893;3450;4140;7590;A
70;0.000290870666504;3500;4200;7700;B
71;0.000239133834839;3550;4260;7810;A
72;0.000290870666504;3600;4320;7920;B
73;0.000240087509155;3650;4380;8030;A
74;0.000291109085083;3700;4440;8140;B
75;0.000240802764893;3750;4500;8250;A
76;0.000298976898193;3800;4560;8360;B
77;0.000241041183472;3850;4620;8470;A
78;0.000293016433716;3900;4680;8580;B
79;0.000242948532104;3950;4740;8690;A
80;0.000293970108032;4000;4800;8800;B
81;0.000242948532104;4050;4860;8910;A
82;0.000253915786743;4100;4920;9020;B
83;0.000267028808594;4150;4980;9130;A
84;0.000256061553955;4200;5040;9240;B
85;0.000257015228271;4250;5100;9350;A
86;0.000257015228271;4300;5160;9460;B
87;0.000257968902588;4350;5220;9570;A
88;0.000257968902588;4400;5280;9680;B
89;0.000257968902588;4450;5340;9790;A
90;0.000257015228271;4500;5400;9900;B
91;0.000258922576904;4550;5460;10010;A
92;0.000258207321167;4600;5520;10120;B
93;0.000264883041382;4650;5580;10230;A
94;0.000257015228271;4700;5640;10340;B
95;0.000259876251221;4750;5700;10450;A
96;0.000265121459961;4800;5760;10560;B
97;0.0002601146698;4850;5820;10670;A
98;0.000262022018433;4900;5880;10780;B
99;0.0002601146698;4950;5940;10890;A
100;0.000259160995483;5000;6000;11000;B
101;0.0002601146698;5050;6060;11110;A
102;0.000259160995483;5100;6120;11220;B
103;0.000261068344116;5150;6180;11330;A
104;0.000257015228271;5200;6240;11440;B
105;0.000261068344116;5250;6300;11550;A
106;0.000264883041382;5300;6360;11660;B
107;0.000267028808594;5350;6420;11770;A
108;0.000262022018433;5400;6480;11880;B
109;0.000259160995483;5450;6540;11990;A
110;0.000262022018433;5500;6600;12100;B
111;0.000262975692749;5550;6660;12210;A
112;0.000262022018433;5600;6720;12320;B
113;0.000262975692749;5650;6780;12430;A
114;0.000257015228271;5700;6840;12540;B
115;0.000262975692749;5750;6900;12650;A
116;0.000277042388916;5800;6960;12760;B
117;0.000265836715698;5850;7020;12870;A
118;0.000258922576904;5900;7080;12980;B
119;0.000257015228271;5950;7140;13090;A
120;0.000266790390015;6000;7200;13200;B
121;0.000261068344116;6050;7260;13310;A
122;0.000259876251221;6100;7320;13420;B
123;0.000267028808594;6150;7380;13530;A
124;0.000263929367065;6200;7440;13640;B
125;0.000271081924438;6250;7500;13750;A
126;0.000259160995483;6300;7560;13860;B
127;0.000262022018433;6350;7620;13970;A
128;0.000256061553955;6400;7680;14080;B
129;0.000262975692749;6450;7740;14190;A
130;0.000260829925537;6500;7800;14300;B
131;0.000262022018433;6550;7860;14410;A
132;0.000261068344116;6600;7920;14520;B
133;0.000264167785645;6650;7980;14630;A
134;0.000261068344116;6700;8040;14740;B
135;0.000267028808594;6750;8100;14850;A
136;0.000268936157227;6800;8160;14960;B
137;0.000266075134277;6850;8220;15070;A
138;0.000316143035889;6900;8280;15180;B
139;0.000266075134277;6950;8340;15290;A
140;0.000313997268677;7000;8400;15400;B
141;0.000265121459961;7050;8460;15510;A
142;0.000315189361572;7100;8520;15620;B
143;0.000264883041382;7150;8580;15730;A
144;0.000318050384521;7200;8640;15840;B
145;0.000268220901489;7250;8700;15950;A
146;0.000317096710205;7300;8760;16060;B
147;0.000267028808594;7350;8820;16170;A
148;0.000314950942993;7400;8880;16280;B
149;0.00026798248291;7450;8940;16390;A
150;0.000324010848999;7500;9000;16500;B
151;0.000268936157227;7550;9060;16610;A
152;0.000342845916748;7600;9120;16720;B
153;0.00030517578125;7650;9180;16830;A
154;0.000316143035889;7700;9240;16940;B
155;0.00026798248291;7750;9300;17050;A
156;0.000319004058838;7800;9360;17160;B
157;0.00026798248291;7850;9420;17270;A
158;0.000319004058838;7900;9480;17380;B
159;0.00026798248291;7950;9540;17490;A
160;0.000323057174683;8000;9600;17600;B
161;0.000275135040283;8050;9660;17710;A
162;0.000318050384521;8100;9720;17820;B
163;0.000268220901489;8150;9780;17930;A
164;0.000281810760498;8200;9840;18040;B
165;0.000280857086182;8250;9900;18150;A
166;0.000282049179077;8300;9960;18260;B
167;0.000286102294922;8350;10020;18370;A
168;0.000320911407471;8400;10080;18480;B
169;0.000300884246826;8450;10140;18590;A
170;0.000323057174683;8500;10200;18700;B
171;0.000286817550659;8550;10260;18810;A
172;0.000283002853394;8600;10320;18920;B
173;0.000284910202026;8650;10380;19030;A
174;0.000280141830444;8700;10440;19140;B
175;0.00028395652771;8750;10500;19250;A
176;0.000282049179077;8800;10560;19360;B
177;0.00028395652771;8850;10620;19470;A
178;0.000282049179077;8900;10680;19580;B
179;0.000283002853394;8950;10740;19690;A
180;0.00028395652771;9000;10800;19800;B
181;0.000284910202026;9050;10860;19910;A
182;0.000278949737549;9100;10920;20020;B
183;0.000290870666504;9150;10980;20130;A
184;0.000282049179077;9200;11040;20240;B
185;0.000283002853394;9250;11100;20350;A
186;0.00028395652771;9300;11160;20460;B
187;0.000284910202026;9350;11220;20570;A
188;0.000282049179077;9400;11280;20680;B
189;0.00028395652771;9450;11340;20790;A
190;0.000283002853394;9500;11400;20900;B
191;0.000283002853394;9550;11460;21010;A
192;0.00028395652771;9600;11520;21120;B
193;0.000285148620605;9650;11580;21230;A
194;0.000284910202026;9700;11640;21340;B
195;0.000282049179077;9750;11700;21450;A
196;0.000285148620605;9800;11760;21560;B
197;0.00028395652771;9850;11820;21670;A
198;0.00028395652771;9900;11880;21780;B
199;0.000284194946289;9950;11940;21890;A
200;0.00028395652771;10000;12000;22000;B
201;0.000284194946289;10050;12060;22110;A
202;0.000280141830444;10100;12120;22220;B
203;0.000285148620605;10150;12180;22330;A
204;0.000280857086182;10200;12240;22440;B
205;0.000284910202026;10250;12300;22550;A
206;0.000281810760498;10300;12360;22660;B
207;0.000285148620605;10350;12420;22770;A
208;0.000283002853394;10400;12480;22880;B
209;0.000284194946289;10450;12540;22990;A
210;0.00028395652771;10500;12600;23100;B
211;0.000284194946289;10550;12660;23210;A
212;0.000283002853394;10600;12720;23320;B
213;0.000286817550659;10650;12780;23430;A
214;0.000283002853394;10700;12840;23540;B
215;0.000286817550659;10750;12900;23650;A
216;0.000281095504761;10800;12960;23760;B
217;0.000283002853394;10850;13020;23870;A
218;0.00028395652771;10900;13080;23980;B
219;0.000283002853394;10950;13140;24090;A
220;0.000286102294922;11000;13200;24200;B
221;0.00028395652771;11050;13260;24310;A
222;0.00028395652771;11100;13320;24420;B
223;0.000284910202026;11150;13380;24530;A
224;0.00028920173645;11200;13440;24640;B
225;0.000286817550659;11250;13500;24750;A
226;0.000282049179077;11300;13560;24860;B
227;0.000285148620605;11350;13620;24970;A
228;0.00028395652771;11400;13680;25080;B
229;0.000286817550659;11450;13740;25190;A
230;0.00028395652771;11500;13800;25300;B
231;0.000284910202026;11550;13860;25410;A
232;0.000285148620605;11600;13920;25520;B
233;0.000284194946289;11650;13980;25630;A
234;0.000286102294922;11700;14040;25740;B
235;0.000284910202026;11750;14100;25850;A
236;0.00028395652771;11800;14160;25960;B
237;0.000284910202026;11850;14220;26070;A
238;0.000285148620605;11900;14280;26180;B
239;0.000282049179077;11950;14340;26290;A
240;0.000283002853394;12000;14400;26400;B
241;0.000286102294922;12050;14460;26510;A
242;0.000283002853394;12100;14520;26620;B
243;0.000287055969238;12150;14580;26730;A
244;0.000285148620605;12200;14640;26840;B
245;0.000283002853394;12250;14700;26950;A
246;0.00028395652771;12300;14760;27060;B
247;0.000283002853394;12350;14820;27170;A
248;0.000283002853394;12400;14880;27280;B
249;0.000286102294922;12450;14940;27390;A
250;0.000284194946289;12500;15000;27500;B
251;0.000284910202026;12550;15060;27610;A
252;0.000284910202026;12600;15120;27720;B
253;0.000284910202026;12650;15180;27830;A
254;0.00028395652771;12700;15240;27940;B
255;0.000285863876343;12750;15300;28050;A
256;0.00028395652771;12800;15360;28160;B
257;0.00028395652771;12850;15420;28270;A
258;0.000282049179077;12900;15480;28380;B
259;0.000288009643555;12950;15540;28490;A
260;0.000284910202026;13000;15600;28600;B
261;0.000287055969238;13050;15660;28710;A
262;0.000285863876343;13100;15720;28820;B
263;0.000285148620605;13150;15780;28930;A
264;0.000284910202026;13200;15840;29040;B
265;0.000284910202026;13250;15900;29150;A
266;0.00028395652771;13300;15960;29260;B
267;0.000286102294922;13350;16020;29370;A
268;0.000285863876343;13400;16080;29480;B
269;0.000285148620605;13450;16140;29590;A
270;0.000288963317871;13500;16200;29700;B
271;0.000285863876343;13550;16260;29810;A
272;0.00028395652771;13600;16320;29920;B
273;0.000284910202026;13650;16380;30030;A
274;0.000338792800903;13700;16440;30140;B
275;0.000288009643555;13750;16500;30250;A
276;0.000335931777954;13800;16560;30360;B
277;0.000288963317871;13850;16620;30470;A
278;0.000336885452271;13900;16680;30580;B
279;0.000288963317871;13950;16740;30690;A
280;0.000341892242432;14000;16800;30800;B
281;0.000287055969238;14050;16860;30910;A
282;0.000338077545166;14100;16920;31020;B
283;0.000287055969238;14150;16980;31130;A
284;0.000344038009644;14200;17040;31240;B
285;0.000284910202026;14250;17100;31350;A
286;0.000341892242432;14300;17160;31460;B
287;0.000288963317871;14350;17220;31570;A
288;0.000340938568115;14400;17280;31680;B
289;0.000286817550659;14450;17340;31790;A
290;0.000336885452271;14500;17400;31900;B
291;0.000285863876343;14550;17460;32010;A
292;0.000342845916748;14600;17520;32120;B
293;0.000288963317871;14650;17580;32230;A
294;0.00033712387085;14700;17640;32340;B
295;0.000289916992188;14750;17700;32450;A
296;0.00033712387085;14800;17760;32560;B
297;0.000288963317871;14850;17820;32670;A
298;0.000339031219482;14900;17880;32780;B
299;0.000288009643555;14950;17940;32890;A
300;0.000335931777954;15000;18000;33000;B
301;0.000299215316772;15050;18060;33110;A
302;0.000341892242432;15100;18120;33220;B
303;0.000291109085083;15150;18180;33330;A
304;0.000343084335327;15200;18240;33440;B
305;0.000287055969238;15250;18300;33550;A
306;0.000339031219482;15300;18360;33660;B
307;0.000287055969238;15350;18420;33770;A
308;0.000341892242432;15400;18480;33880;B
309;0.000288009643555;15450;18540;33990;A
310;0.000339031219482;15500;18600;34100;B
311;0.000290870666504;15550;18660;34210;A
312;0.00033712387085;15600;18720;34320;B
313;0.000288963317871;15650;18780;34430;A
314;0.000338077545166;15700;18840;34540;B
315;0.000288009643555;15750;18900;34650;A
316;0.000341176986694;15800;18960;34760;B
317;0.000288009643555;15850;19020;34870;A
318;0.000338792800903;15900;19080;34980;B
319;0.000286817550659;15950;19140;35090;A
320;0.000339984893799;16000;19200;35200;B
321;0.000288009643555;16050;19260;35310;A
322;0.000339031219482;16100;19320;35420;B
323;0.000287055969238;16150;19380;35530;A
324;0.000339984893799;16200;19440;35640;B
325;0.000288009643555;16250;19500;35750;A
326;0.000338077545166;16300;19560;35860;B
327;0.000289916992188;16350;19620;35970;A
328;0.000303983688354;16400;19680;36080;B
329;0.000304937362671;16450;19740;36190;A
330;0.000302791595459;16500;19800;36300;B
331;0.000304937362671;16550;19860;36410;A
332;0.000304937362671;16600;19920;36520;B
333;0.000303030014038;16650;19980;36630;A
334;0.000304937362671;16700;20040;36740;B
335;0.00031304359436;16750;20100;36850;A
336;0.000304937362671;16800;20160;36960;B
337;0.000308036804199;16850;20220;37070;A
338;0.000304222106934;16900;20280;37180;B
339;0.000306844711304;16950;20340;37290;A
340;0.000303030014038;17000;20400;37400;B
341;0.000306129455566;17050;20460;37510;A
342;0.000304937362671;17100;20520;37620;B
343;0.00030517578125;17150;20580;37730;A
344;0.000304937362671;17200;20640;37840;B
345;0.000303983688354;17250;20700;37950;A
346;0.000305891036987;17300;20760;38060;B
347;0.000304937362671;17350;20820;38170;A
348;0.000303983688354;17400;20880;38280;B
349;0.000303983688354;17450;20940;38390;A
350;0.000304937362671;17500;21000;38500;B
351;0.000303983688354;17550;21060;38610;A
352;0.000303030014038;17600;21120;38720;B
353;0.000305891036987;17650;21180;38830;A
354;0.000304937362671;17700;21240;38940;B
355;0.00030517578125;17750;21300;39050;A
356;0.000303030014038;17800;21360;39160;B
357;0.000304222106934;17850;21420;39270;A
358;0.000306129455566;17900;21480;39380;B
359;0.000307083129883;17950;21540;39490;A
360;0.000303983688354;18000;21600;39600;B
361;0.000307083129883;18050;21660;39710;A
362;0.000303030014038;18100;21720;39820;B
363;0.000311136245728;18150;21780;39930;A
364;0.000305891036987;18200;21840;40040;B
365;0.000306129455566;18250;21900;40150;A
366;0.000301837921143;18300;21960;40260;B
367;0.00030517578125;18350;22020;40370;A
368;0.000307083129883;18400;22080;40480;B
369;0.000305891036987;18450;22140;40590;A
370;0.000305891036987;18500;22200;40700;B
371;0.000304937362671;18550;22260;40810;A
372;0.000303983688354;18600;22320;40920;B
373;0.000303983688354;18650;22380;41030;A
374;0.000304937362671;18700;22440;41140;B
375;0.000304937362671;18750;22500;41250;A
376;0.000303030014038;18800;22560;41360;B
377;0.000304937362671;18850;22620;41470;A
378;0.00030517578125;18900;22680;41580;B
379;0.000304937362671;18950;22740;41690;A
380;0.000303983688354;19000;22800;41800;B
381;0.000304937362671;19050;22860;41910;A
382;0.00030517578125;19100;22920;42020;B
383;0.000306844711304;19150;22980;42130;A
384;0.000308036804199;19200;23040;42240;B
385;0.000306129455566;19250;23100;42350;A
386;0.000306129455566;19300;23160;42460;B
387;0.000306129455566;19350;23220;42570;A
388;0.000303983688354;19400;23280;42680;B
389;0.000306129455566;19450;23340;42790;A
390;0.00030517578125;19500;23400;42900;B
391;0.000307083129883;19550;23460;43010;A
392;0.000303983688354;19600;23520;43120;B
393;0.000306129455566;19650;23580;43230;A
394;0.000307083129883;19700;23640;43340;B
395;0.000303983688354;19750;23700;43450;A
396;0.000305891036987;19800;23760;43560;B
397;0.000309944152832;19850;23820;43670;A
398;0.000307083129883;19900;23880;43780;B
399;0.000308036804199;19950;23940;43890;A
400;0.000303983688354;20000;24000;44000;B
401;0.00030517578125;20050;24060;44110;A
402;0.000303983688354;20100;24120;44220;B
403;0.000303983688354;20150;24180;44330;A
404;0.000302791595459;20200;24240;44440;B
405;0.00030517578125;20250;24300;44550;A
406;0.000301122665405;20300;24360;44660;B
407;0.000309944152832;20350;24420;44770;A
408;0.000307083129883;20400;24480;44880;B
409;0.000306844711304;20450;24540;44990;A
410;0.000305891036987;20500;24600;45100;B
411;0.000306844711304;20550;24660;45210;A
412;0.000306844711304;20600;24720;45320;B
413;0.000305891036987;20650;24780;45430;A
414;0.00030517578125;20700;24840;45540;B
415;0.000307083129883;20750;24900;45650;A
416;0.00030517578125;20800;24960;45760;B
417;0.000308990478516;20850;25020;45870;A
418;0.000304937362671;20900;25080;45980;B
419;0.000306129455566;20950;25140;46090;A
420;0.000304937362671;21000;25200;46200;B
421;0.000305891036987;21050;25260;46310;A
422;0.000305891036987;21100;25320;46420;B
423;0.000306129455566;21150;25380;46530;A
424;0.000303983688354;21200;25440;46640;B
425;0.000308036804199;21250;25500;46750;A
426;0.000308036804199;21300;25560;46860;B
427;0.000306129455566;21350;25620;46970;A
428;0.000307083129883;21400;25680;47080;B
429;0.000306129455566;21450;25740;47190;A
430;0.000304937362671;21500;25800;47300;B
431;0.000306129455566;21550;25860;47410;A
432;0.000303983688354;21600;25920;47520;B
433;0.000307083129883;21650;25980;47630;A
434;0.000308036804199;21700;26040;47740;B
435;0.000307083129883;21750;26100;47850;A
436;0.00030517578125;21800;26160;47960;B
437;0.00030517578125;21850;26220;48070;A
438;0.000304937362671;21900;26280;48180;B
439;0.00030779838562;21950;26340;48290;A
440;0.000304937362671;22000;26400;48400;B
441;0.000308036804199;22050;26460;48510;A
442;0.000303983688354;22100;26520;48620;B
443;0.000337839126587;22150;26580;48730;A
444;0.000308036804199;22200;26640;48840;B
445;0.000303983688354;22250;26700;48950;A
446;0.000308036804199;22300;26760;49060;B
447;0.00030517578125;22350;26820;49170;A
448;0.000306129455566;22400;26880;49280;B
449;0.000308036804199;22450;26940;49390;A
450;0.00030517578125;22500;27000;49500;B
451;0.000317096710205;22550;27060;49610;A
452;0.000303030014038;22600;27120;49720;B
453;0.000314950942993;22650;27180;49830;A
454;0.000308036804199;22700;27240;49940;B
455;0.000304937362671;22750;27300;50050;A
456;0.000307083129883;22800;27360;50160;B
457;0.000306844711304;22850;27420;50270;A
458;0.000303983688354;22900;27480;50380;B
459;0.000305891036987;22950;27540;50490;A
460;0.000304937362671;23000;27600;50600;B
461;0.000307083129883;23050;27660;50710;A
462;0.000308036804199;23100;27720;50820;B
463;0.000306129455566;23150;27780;50930;A
464;0.000309228897095;23200;27840;51040;B
465;0.000308036804199;23250;27900;51150;A
466;0.000306129455566;23300;27960;51260;B
467;0.000307083129883;23350;28020;51370;A
468;0.000307083129883;23400;28080;51480;B
469;0.000346899032593;23450;28140;51590;A
470;0.00030517578125;23500;28200;51700;B
471;0.000308036804199;23550;28260;51810;A
472;0.000303983688354;23600;28320;51920;B
473;0.000304937362671;23650;28380;52030;A
474;0.000307083129883;23700;28440;52140;B
475;0.000308036804199;23750;28500;52250;A
476;0.000306129455566;23800;28560;52360;B
477;0.00031304359436;23850;28620;52470;A
478;0.000304937362671;23900;28680;52580;B
479;0.000308990478516;23950;28740;52690;A
480;0.000305891036987;24000;28800;52800;B
481;0.000306844711304;24050;28860;52910;A
482;0.000303983688354;24100;28920;53020;B
483;0.000308990478516;24150;28980;53130;A
484;0.000305891036987;24200;29040;53240;B
485;0.000308036804199;24250;29100;53350;A
486;0.000304937362671;24300;29160;53460;B
487;0.000303983688354;24350;29220;53570;A
488;0.000308036804199;24400;29280;53680;B
489;0.000305891036987;24450;29340;53790;A
490;0.000304937362671;24500;29400;53900;B
491;0.000308990478516;24550;29460;54010;A
492;0.000306844711304;24600;29520;54120;B
493;0.000305891036987;24650;29580;54230;A
494;0.000306844711304;24700;29640;54340;B
495;0.000308036804199;24750;29700;54450;A
496;0.000305891036987;24800;29760;54560;B
497;0.000307083129883;24850;29820;54670;A
498;0.000307083129883;24900;29880;54780;B
499;0.000437021255493;24950;29940;54890;A
500;0.000304937362671;25000;30000;55000;B
501;0.00030779838562;25050;30060;55110;A
502;0.000307083129883;25100;30120;55220;B
503;0.000306129455566;25150;30180;55330;A
504;0.00030779838562;25200;30240;55440;B
505;0.000311136245728;25250;30300;55550;A
506;0.000305891036987;25300;30360;55660;B
507;0.00030779838562;25350;30420;55770;A
508;0.000305891036987;25400;30480;55880;B
509;0.000308990478516;25450;30540;55990;A
510;0.000307083129883;25500;30600;56100;B
511;0.000309944152832;25550;30660;56210;A
512;0.000310182571411;25600;30720;56320;B
513;0.000308990478516;25650;30780;56430;A
514;0.000347137451172;25700;30840;56540;B
515;0.000306129455566;25750;30900;56650;A
516;0.000304937362671;25800;30960;56760;B
517;0.000308990478516;25850;31020;56870;A
518;0.000306129455566;25900;31080;56980;B
519;0.000307083129883;25950;31140;57090;A
520;0.000304937362671;26000;31200;57200;B
521;0.000308036804199;26050;31260;57310;A
522;0.000303983688354;26100;31320;57420;B
523;0.000308990478516;26150;31380;57530;A
524;0.000306129455566;26200;31440;57640;B
525;0.000308036804199;26250;31500;57750;A
526;0.000306129455566;26300;31560;57860;B
527;0.00030779838562;26350;31620;57970;A
528;0.000306844711304;26400;31680;58080;B
529;0.000303983688354;26450;31740;58190;A
530;0.000307083129883;26500;31800;58300;B
531;0.000312805175781;26550;31860;58410;A
532;0.000304937362671;26600;31920;58520;B
533;0.000308990478516;26650;31980;58630;A
534;0.00030517578125;26700;32040;58740;B
535;0.00031304359436;26750;32100;58850;A
536;0.000303983688354;26800;32160;58960;B
537;0.000305891036987;26850;32220;59070;A
538;0.000309944152832;26900;32280;59180;B
539;0.000306129455566;26950;32340;59290;A
540;0.000306129455566;27000;32400;59400;B
541;0.000308990478516;27050;32460;59510;A
542;0.000308036804199;27100;32520;59620;B
543;0.000308990478516;27150;32580;59730;A
544;0.000308036804199;27200;32640;59840;B
545;0.000310182571411;27250;32700;59950;A
546;0.000307083129883;27300;32760;60060;B
547;0.000308990478516;27350;32820;60170;A
548;0.000361204147339;27400;32880;60280;B
549;0.000308990478516;27450;32940;60390;A
550;0.000360012054443;27500;33000;60500;B
551;0.000308036804199;27550;33060;60610;A
552;0.000360012054443;27600;33120;60720;B
553;0.000309944152832;27650;33180;60830;A
554;0.000359773635864;27700;33240;60940;B
555;0.000308036804199;27750;33300;61050;A
556;0.000359058380127;27800;33360;61160;B
557;0.000306844711304;27850;33420;61270;A
558;0.000364780426025;27900;33480;61380;B
559;0.000308036804199;27950;33540;61490;A
560;0.000362873077393;28000;33600;61600;B
561;0.000310897827148;28050;33660;61710;A
562;0.000360012054443;28100;33720;61820;B
563;0.000308036804199;28150;33780;61930;A
564;0.000362157821655;28200;33840;62040;B
565;0.000311136245728;28250;33900;62150;A
566;0.00036096572876;28300;33960;62260;B
567;0.000308990478516;28350;34020;62370;A
568;0.000357866287231;28400;34080;62480;B
569;0.000308036804199;28450;34140;62590;A
570;0.000360012054443;28500;34200;62700;B
571;0.000311136245728;28550;34260;62810;A
572;0.000360012054443;28600;34320;62920;B
573;0.000309228897095;28650;34380;63030;A
574;0.000363111495972;28700;34440;63140;B
575;0.000305891036987;28750;34500;63250;A
576;0.000364065170288;28800;34560;63360;B
577;0.00031304359436;28850;34620;63470;A
578;0.00036096572876;28900;34680;63580;B
579;0.000312089920044;28950;34740;63690;A
580;0.000363111495972;29000;34800;63800;B
581;0.000308990478516;29050;34860;63910;A
582;0.000363111495972;29100;34920;64020;B
583;0.00031304359436;29150;34980;64130;A
584;0.000364065170288;29200;35040;64240;B
585;0.000309944152832;29250;35100;64350;A
586;0.000363111495972;29300;35160;64460;B
587;0.000310897827148;29350;35220;64570;A
588;0.000365018844604;29400;35280;64680;B
589;0.000311136245728;29450;35340;64790;A
590;0.000366926193237;29500;35400;64900;B
591;0.00031304359436;29550;35460;65010;A
592;0.000375986099243;29600;35520;65120;B
593;0.000313997268677;29650;35580;65230;A
594;0.00036096572876;29700;35640;65340;B
595;0.000312089920044;29750;35700;65450;A
596;0.000362873077393;29800;35760;65560;B
597;0.000311136245728;29850;35820;65670;A
598;0.000359058380127;29900;35880;65780;B
599;0.000310897827148;29950;35940;65890;A
600;0.000363111495972;30000;36000;66000;B
601;0.000313997268677;30050;36060;66110;A
602;0.000363111495972;30100;36120;66220;B
603;0.000309944152832;30150;36180;66330;A
604;0.000361204147339;30200;36240;66440;B
605;0.000312089920044;30250;36300;66550;A
606;0.000358819961548;30300;36360;66660;B
607;0.000308036804199;30350;36420;66770;A
608;0.000358819961548;30400;36480;66880;B
609;0.000310897827148;30450;36540;66990;A
610;0.000360012054443;30500;36600;67100;B
611;0.000311851501465;30550;36660;67210;A
612;0.000720977783203;30600;36720;67320;B
613;0.000323057174683;30650;36780;67430;A
614;0.00037693977356;30700;36840;67540;B
615;0.00030779838562;30750;36900;67650;A
616;0.000360012054443;30800;36960;67760;B
617;0.000309944152832;30850;37020;67870;A
618;0.000360012054443;30900;37080;67980;B
619;0.00031304359436;30950;37140;68090;A
620;0.00036096572876;31000;37200;68200;B
621;0.00031304359436;31050;37260;68310;A
622;0.000363826751709;31100;37320;68420;B
623;0.000308990478516;31150;37380;68530;A
624;0.000362157821655;31200;37440;68640;B
625;0.000312089920044;31250;37500;68750;A
626;0.000360012054443;31300;37560;68860;B
627;0.000312089920044;31350;37620;68970;A
628;0.000361919403076;31400;37680;69080;B
629;0.000312805175781;31450;37740;69190;A
630;0.000363826751709;31500;37800;69300;B
631;0.00031304359436;31550;37860;69410;A
632;0.000363111495972;31600;37920;69520;B
633;0.000314950942993;31650;37980;69630;A
634;0.000365018844604;31700;38040;69740;B
635;0.00031304359436;31750;38100;69850;A
636;0.000359773635864;31800;38160;69960;B
637;0.000310182571411;31850;38220;70070;A
638;0.000359058380127;31900;38280;70180;B
639;0.00031304359436;31950;38340;70290;A
640;0.000363111495972;32000;38400;70400;B
641;0.00031590461731;32050;38460;70510;A
642;0.000360012054443;32100;38520;70620;B
643;0.000314950942993;32150;38580;70730;A
644;0.000363826751709;32200;38640;70840;B
645;0.000312089920044;32250;38700;70950;A
646;0.000361919403076;32300;38760;71060;B
647;0.000308036804199;32350;38820;71170;A
648;0.000365972518921;32400;38880;71280;B
649;0.000314950942993;32450;38940;71390;A
650;0.000364065170288;32500;39000;71500;B
651;0.000313997268677;32550;39060;71610;A
652;0.000361919403076;32600;39120;71720;B
653;0.000313997268677;32650;39180;71830;A
654;0.00036096572876;32700;39240;71940;B
655;0.000311136245728;32750;39300;72050;A
656;0.000332117080688;32800;39360;72160;B
657;0.000325918197632;32850;39420;72270;A
658;0.000325918197632;32900;39480;72380;B
659;0.000329971313477;32950;39540;72490;A
660;0.000326871871948;33000;39600;72600;B
661;0.000326871871948;33050;39660;72710;A
662;0.000328063964844;33100;39720;72820;B
663;0.000328063964844;33150;39780;72930;A
664;0.000326156616211;33200;39840;73040;B
665;0.000330924987793;33250;39900;73150;A
666;0.00032114982605;33300;39960;73260;B
667;0.000329971313477;33350;40020;73370;A
668;0.000324964523315;33400;40080;73480;B
669;0.000326871871948;33450;40140;73590;A
670;0.000323057174683;33500;40200;73700;B
671;0.000331163406372;33550;40260;73810;A
672;0.000325918197632;33600;40320;73920;B
673;0.000326156616211;33650;40380;74030;A
674;0.000327110290527;33700;40440;74140;B
675;0.000329971313477;33750;40500;74250;A
676;0.00032901763916;33800;40560;74360;B
677;0.00032901763916;33850;40620;74470;A
678;0.000326871871948;33900;40680;74580;B
679;0.00039005279541;33950;40740;74690;A
680;0.000327110290527;34000;40800;74800;B
681;0.000329971313477;34050;40860;74910;A
682;0.000323057174683;34100;40920;75020;B
683;0.00032901763916;34150;40980;75130;A
684;0.000327110290527;34200;41040;75240;B
685;0.000329971313477;34250;41100;75350;A
686;0.000323057174683;34300;41160;75460;B
687;0.000329971313477;34350;41220;75570;A
688;0.000328063964844;34400;41280;75680;B
689;0.000323057174683;34450;41340;75790;A
690;0.000328063964844;34500;41400;75900;B
691;0.000332832336426;34550;41460;76010;A
692;0.000329971313477;34600;41520;76120;B
693;0.000328063964844;34650;41580;76230;A
694;0.000324964523315;34700;41640;76340;B
695;0.000330924987793;34750;41700;76450;A
696;0.00034499168396;34800;41760;76560;B
697;0.000327110290527;34850;41820;76670;A
698;0.000324964523315;34900;41880;76780;B
699;0.00032901763916;34950;41940;76890;A
700;0.000325918197632;35000;42000;77000;B
701;0.000329971313477;35050;42060;77110;A
702;0.000324964523315;35100;42120;77220;B
703;0.000327825546265;35150;42180;77330;A
704;0.000325202941895;35200;42240;77440;B
705;0.000325918197632;35250;42300;77550;A
706;0.000325918197632;35300;42360;77660;B
707;0.00033712387085;35350;42420;77770;A
708;0.000326871871948;35400;42480;77880;B
709;0.00032901763916;35450;42540;77990;A
710;0.000324964523315;35500;42600;78100;B
711;0.00032901763916;35550;42660;78210;A
712;0.000326871871948;35600;42720;78320;B
713;0.000324964523315;35650;42780;78430;A
714;0.000325918197632;35700;42840;78540;B
715;0.000329971313477;35750;42900;78650;A
716;0.000334978103638;35800;42960;78760;B
717;0.000329971313477;35850;43020;78870;A
718;0.000327110290527;35900;43080;78980;B
719;0.00033712387085;35950;43140;79090;A
720;0.000324010848999;36000;43200;79200;B
721;0.000330209732056;36050;43260;79310;A
722;0.000325918197632;36100;43320;79420;B
723;0.000330924987793;36150;43380;79530;A
724;0.000328063964844;36200;43440;79640;B
725;0.000329971313477;36250;43500;79750;A
726;0.000321865081787;36300;43560;79860;B
727;0.000329971313477;36350;43620;79970;A
728;0.000326871871948;36400;43680;80080;B
729;0.000330209732056;36450;43740;80190;A
730;0.000328063964844;36500;43800;80300;B
731;0.000331163406372;36550;43860;80410;A
732;0.000327110290527;36600;43920;80520;B
733;0.00032901763916;36650;43980;80630;A
734;0.000326871871948;36700;44040;80740;B
735;0.000331878662109;36750;44100;80850;A
736;0.000324964523315;36800;44160;80960;B
737;0.000328063964844;36850;44220;81070;A
738;0.000324964523315;36900;44280;81180;B
739;0.000334978103638;36950;44340;81290;A
740;0.000327825546265;37000;44400;81400;B
741;0.000331878662109;37050;44460;81510;A
742;0.000328063964844;37100;44520;81620;B
743;0.00032901763916;37150;44580;81730;A
744;0.000325918197632;37200;44640;81840;B
745;0.00032901763916;37250;44700;81950;A
746;0.000328063964844;37300;44760;82060;B
747;0.000331878662109;37350;44820;82170;A
748;0.000325918197632;37400;44880;82280;B
749;0.00032901763916;37450;44940;82390;A
750;0.00032901763916;37500;45000;82500;B
751;0.000330209732056;37550;45060;82610;A
752;0.000327825546265;37600;45120;82720;B
753;0.000328063964844;37650;45180;82830;A
754;0.000327110290527;37700;45240;82940;B
755;0.000331878662109;37750;45300;83050;A
756;0.000325918197632;37800;45360;83160;B
757;0.000331163406372;37850;45420;83270;A
758;0.000326156616211;37900;45480;83380;B
759;0.000327825546265;37950;45540;83490;A
760;0.00032901763916;38000;45600;83600;B
761;0.00032901763916;38050;45660;83710;A
762;0.00032901763916;38100;45720;83820;B
763;0.000329971313477;38150;45780;83930;A
764;0.000346899032593;38200;45840;84040;B
765;0.000340938568115;38250;45900;84150;A
766;0.000327110290527;38300;45960;84260;B
767;0.000327110290527;38350;46020;84370;A
768;0.000326156616211;38400;46080;84480;B
769;0.000328063964844;38450;46140;84590;A
770;0.000323057174683;38500;46200;84700;B
771;0.000328063964844;38550;46260;84810;A
772;0.000325918197632;38600;46320;84920;B
773;0.000331163406372;38650;46380;85030;A
774;0.000324010848999;38700;46440;85140;B
775;0.00032901763916;38750;46500;85250;A
776;0.000325918197632;38800;46560;85360;B
777;0.000330924987793;38850;46620;85470;A
778;0.000326871871948;38900;46680;85580;B
779;0.000322818756104;38950;46740;85690;A
780;0.000326871871948;39000;46800;85800;B
781;0.000332832336426;39050;46860;85910;A
782;0.000320196151733;39100;46920;86020;B
783;0.000332117080688;39150;46980;86130;A
784;0.000328063964844;39200;47040;86240;B
785;0.000332117080688;39250;47100;86350;A
786;0.000327110290527;39300;47160;86460;B
787;0.000334024429321;39350;47220;86570;A
788;0.000327110290527;39400;47280;86680;B
789;0.000333786010742;39450;47340;86790;A
790;0.000328063964844;39500;47400;86900;B
791;0.00032901763916;39550;47460;87010;A
792;0.000327825546265;39600;47520;87120;B
793;0.00032901763916;39650;47580;87230;A
794;0.000328063964844;39700;47640;87340;B
795;0.000329971313477;39750;47700;87450;A
796;0.000327825546265;39800;47760;87560;B
797;0.000332117080688;39850;47820;87670;A
798;0.000328063964844;39900;47880;87780;B
799;0.000332117080688;39950;47940;87890;A
800;0.000327110290527;40000;48000;88000;B
801;0.000329971313477;40050;48060;88110;A
802;0.000329971313477;40100;48120;88220;B
803;0.000332117080688;40150;48180;88330;A
804;0.00032901763916;40200;48240;88440;B
805;0.000329971313477;40250;48300;88550;A
806;0.000328063964844;40300;48360;88660;B
807;0.000334024429321;40350;48420;88770;A
808;0.000326156616211;40400;48480;88880;B
809;0.000324964523315;40450;48540;88990;A
810;0.000328063964844;40500;48600;89100;B
811;0.000329971313477;40550;48660;89210;A
812;0.000325918197632;40600;48720;89320;B
813;0.000329971313477;40650;48780;89430;A
814;0.000324964523315;40700;48840;89540;B
815;0.000334024429321;40750;48900;89650;A
816;0.000324010848999;40800;48960;89760;B
817;0.000334024429321;40850;49020;89870;A
818;0.000328063964844;40900;49080;89980;B
819;0.000326156616211;40950;49140;90090;A
820;0.000339984893799;41000;49200;90200;B
821;0.000329971313477;41050;49260;90310;A
822;0.00032901763916;41100;49320;90420;B
823;0.000333070755005;41150;49380;90530;A
824;0.00032901763916;41200;49440;90640;B
825;0.000329971313477;41250;49500;90750;A
826;0.000329971313477;41300;49560;90860;B
827;0.00032901763916;41350;49620;90970;A
828;0.000326156616211;41400;49680;91080;B
829;0.000332117080688;41450;49740;91190;A
830;0.000324964523315;41500;49800;91300;B
831;0.000333070755005;41550;49860;91410;A
832;0.000326156616211;41600;49920;91520;B
833;0.000331163406372;41650;49980;91630;A
834;0.000326871871948;41700;50040;91740;B
835;0.000334024429321;41750;50100;91850;A
836;0.00032901763916;41800;50160;91960;B
837;0.000375986099243;41850;50220;92070;A
838;0.000372886657715;41900;50280;92180;B
839;0.000375032424927;41950;50340;92290;A
840;0.000380992889404;42000;50400;92400;B
841;0.000373840332031;42050;50460;92510;A
842;0.000382900238037;42100;50520;92620;B
843;0.000386953353882;42150;50580;92730;A
844;0.000375032424927;42200;50640;92840;B
845;0.00037407875061;42250;50700;92950;A
846;0.00037693977356;42300;50760;93060;B
847;0.000380992889404;42350;50820;93170;A
848;0.000371932983398;42400;50880;93280;B
849;0.00037693977356;42450;50940;93390;A
850;0.000370979309082;42500;51000;93500;B
851;0.000388145446777;42550;51060;93610;A
852;0.000380992889404;42600;51120;93720;B
853;0.000373840332031;42650;51180;93830;A
854;0.000390768051147;42700;51240;93940;B
855;0.000400066375732;42750;51300;94050;A
856;0.000385999679565;42800;51360;94160;B
857;0.000378131866455;42850;51420;94270;A
858;0.00037407875061;42900;51480;94380;B
859;0.000391960144043;42950;51540;94490;A
860;0.00039005279541;43000;51600;94600;B
861;0.000391960144043;43050;51660;94710;A
862;0.000326871871948;43100;51720;94820;B
863;0.000335216522217;43150;51780;94930;A
864;0.000325918197632;43200;51840;95040;B
865;0.000330924987793;43250;51900;95150;A
866;0.000326871871948;43300;51960;95260;B
867;0.000332117080688;43350;52020;95370;A
868;0.000327110290527;43400;52080;95480;B
869;0.000329971313477;43450;52140;95590;A
870;0.00032901763916;43500;52200;95700;B
871;0.000334024429321;43550;52260;95810;A
872;0.000329971313477;43600;52320;95920;B
873;0.00032901763916;43650;52380;96030;A
874;0.000329971313477;43700;52440;96140;B
875;0.000332832336426;43750;52500;96250;A
876;0.000329971313477;43800;52560;96360;B
877;0.00032901763916;43850;52620;96470;A
878;0.000334024429321;43900;52680;96580;B
879;0.000334978103638;43950;52740;96690;A
880;0.000325918197632;44000;52800;96800;B
881;0.000334024429321;44050;52860;96910;A
882;0.000331878662109;44100;52920;97020;B
883;0.000329971313477;44150;52980;97130;A
884;0.000329971313477;44200;53040;97240;B
885;0.000391006469727;44250;53100;97350;A
886;0.000329971313477;44300;53160;97460;B
887;0.000331878662109;44350;53220;97570;A
888;0.000327110290527;44400;53280;97680;B
889;0.000327110290527;44450;53340;97790;A
890;0.000331878662109;44500;53400;97900;B
891;0.000332117080688;44550;53460;98010;A
892;0.00032901763916;44600;53520;98120;B
893;0.000334978103638;44650;53580;98230;A
894;0.00032901763916;44700;53640;98340;B
895;0.000330209732056;44750;53700;98450;A
896;0.00032901763916;44800;53760;98560;B
897;0.000330209732056;44850;53820;98670;A
898;0.000329971313477;44900;53880;98780;B
899;0.000333070755005;44950;53940;98890;A
900;0.000330209732056;45000;54000;99000;B
901;0.000338077545166;45050;54060;99110;A
902;0.000335931777954;45100;54120;99220;B
903;0.000332117080688;45150;54180;99330;A
904;0.000331878662109;45200;54240;99440;B
905;0.000334024429321;45250;54300;99550;A
906;0.00033712387085;45300;54360;99660;B
907;0.000334024429321;45350;54420;99770;A
908;0.000329971313477;45400;54480;99880;B
909;0.000331878662109;45450;54540;99990;A
910;0.000328063964844;45500;54600;100100;B
911;0.000327110290527;45550;54660;100210;A
912;0.000327825546265;45600;54720;100320;B
913;0.000335931777954;45650;54780;100430;A
914;0.000327110290527;45700;54840;100540;B
915;0.000329971313477;45750;54900;100650;A
916;0.000332117080688;45800;54960;100760;B
917;0.000330924987793;45850;55020;100870;A
918;0.000328063964844;45900;55080;100980;B
919;0.000334978103638;45950;55140;101090;A
920;0.00032901763916;46000;55200;101200;B
921;0.000327825546265;46050;55260;101310;A
922;0.000329971313477;46100;55320;101420;B
923;0.000331163406372;46150;55380;101530;A
924;0.000329971313477;46200;55440;101640;B
925;0.000329971313477;46250;55500;101750;A
926;0.000325918197632;46300;55560;101860;B
927;0.000333786010742;46350;55620;101970;A
928;0.000330924987793;46400;55680;102080;B
929;0.000332832336426;46450;55740;102190;A
930;0.00032901763916;46500;55800;102300;B
931;0.000334024429321;46550;55860;102410;A
932;0.000329971313477;46600;55920;102520;B
933;0.000333070755005;46650;55980;102630;A
934;0.000329971313477;46700;56040;102740;B
935;0.000331878662109;46750;56100;102850;A
936;0.00032901763916;46800;56160;102960;B
937;0.000334024429321;46850;56220;103070;A
938;0.00032901763916;46900;56280;103180;B
939;0.000339031219482;46950;56340;103290;A
940;0.000326871871948;47000;56400;103400;B
941;0.000338077545166;47050;56460;103510;A
942;0.00032901763916;47100;56520;103620;B
943;0.000337839126587;47150;56580;103730;A
944;0.00032901763916;47200;56640;103840;B
945;0.000332832336426;47250;56700;103950;A
946;0.000329971313477;47300;56760;104060;B
947;0.000385046005249;47350;56820;104170;A
948;0.00032901763916;47400;56880;104280;B
949;0.000336885452271;47450;56940;104390;A
950;0.000329971313477;47500;57000;104500;B
951;0.000334024429321;47550;57060;104610;A
952;0.000329971313477;47600;57120;104720;B
953;0.000334978103638;47650;57180;104830;A
954;0.000328063964844;47700;57240;104940;B
955;0.000331163406372;47750;57300;105050;A
956;0.000330924987793;47800;57360;105160;B
957;0.00032901763916;47850;57420;105270;A
958;0.000330924987793;47900;57480;105380;B
959;0.000334978103638;47950;57540;105490;A
960;0.000335931777954;48000;57600;105600;B
961;0.000334978103638;48050;57660;105710;A
962;0.000330924987793;48100;57720;105820;B
963;0.000334024429321;48150;57780;105930;A
964;0.000334978103638;48200;57840;106040;B
965;0.000331163406372;48250;57900;106150;A
966;0.000335931777954;48300;57960;106260;B
967;0.000336885452271;48350;58020;106370;A
968;0.000329971313477;48400;58080;106480;B
969;0.000335931777954;48450;58140;106590;A
970;0.000331878662109;48500;58200;106700;B
971;0.000334024429321;48550;58260;106810;A
972;0.000333786010742;48600;58320;106920;B
973;0.000331163406372;48650;58380;107030;A
974;0.000332117080688;48700;58440;107140;B
975;0.000333070755005;48750;58500;107250;A
976;0.000334024429321;48800;58560;107360;B
977;0.000334024429321;48850;58620;107470;A
978;0.000330924987793;48900;58680;107580;B
979;0.000336170196533;48950;58740;107690;A
980;0.000328063964844;49000;58800;107800;B
981;0.000332832336426;49050;58860;107910;A
982;0.000329971313477;49100;58920;108020;B
983;0.000334024429321;49150;58980;108130;A
984;0.00032901763916;49200;59040;108240;B
985;0.000331878662109;49250;59100;108350;A
986;0.000330924987793;49300;59160;108460;B
987;0.000340938568115;49350;59220;108570;A
988;0.000327110290527;49400;59280;108680;B
989;0.000334978103638;49450;59340;108790;A
990;0.00032901763916;49500;59400;108900;B
991;0.000335931777954;49550;59460;109010;A
992;0.00033712387085;49600;59520;109120;B
993;0.000339031219482;49650;59580;109230;A
994;0.000330924987793;49700;59640;109340;B
995;0.000336170196533;49750;59700;109450;A
996;0.000331878662109;49800;59760;109560;B
997;0.000355005264282;49850;59820;109670;A
998;0.00035285949707;49900;59880;109780;B
999;0.00032901763916;49950;59940;109890;A
1000;0.000335216522217;50000;60000;110000;B